{
  "name": "L-Corridor",
  "playerStart": {
    "col": 1,
    "row": 1,
    "facing": "S"
  },
  "layers": [
    {
      "id": "0",
      "grid": [
        "##########",
        "#........#",
        "#.######.#",
        "#.#....#.#",
        "#.#.##.#.#",
        "#.#..#...#",
        "#.####.###",
        "#........#",
        "##########"
      ],
      "entities": []
    }
  ]
}