{
  "name": "L-Corridor",
  "grid": [
    "##########",
    "#........#",
    "#.######.#",
    "#.#....#.#",
    "#.#.##.#.#",
    "#.#..#...#",
    "#.####.###",
    "#........#",
    "##########"
  ],
  "playerStart": { "col": 1, "row": 1, "facing": "S" },
  "entities": []
}
