{
  "name": "First Room",
  "grid": [
    "####################",
    "#####...############",
    "#####.#...##########",
    "##....#...##########",
    "#.....#...##########",
    "#..#################",
    "####################"
  ],
  "playerStart": { "col": 1, "row": 5, "facing": "N" },
  "entities": []
}
