{
  "name": "First Room",
  "playerStart": {
    "col": 1,
    "row": 5,
    "facing": "N"
  },
  "layers": [
    {
      "id": "0",
      "grid": [
        "####################",
        "#####...############",
        "#####.#...##########",
        "##....#...##########",
        "#.....#...##########",
        "#..#################",
        "####################"
      ],
      "entities": []
    }
  ]
}